{
    "markers": [
        {"id": 0, "gx": 0, "gy": 0},
        {"id": 1, "gx": 4, "gy": 0},
        {"id": 2, "gx": 9, "gy": 0},
        {"id": 3, "gx": 0, "gy": 4},
        {"id": 4, "gx": 4, "gy": 4},
        {"id": 5, "gx": 9, "gy": 4},
        {"id": 6, "gx": 0, "gy": 9},
        {"id": 7, "gx": 4, "gy": 9},
        {"id": 8, "gx": 9, "gy": 9}
    ]
}
